000000000000000000000000000000000000000000000000000000000000000000000000000000000000000000
000000000001111111222000000000000000000001000000000000000000000001111110000000000000000000
000000000000000000000000000000000000000110000000000000000000000000000000000000000000000000
000000000022220000000000000000000001111110000000000000000000000000000000000000000000000000
000000000000000000001111111100000000000000000000000000000000000000000000000000000000000000
000000000000001111111111111111122222222222222111111111111111111111111111111111111111111111
222222222222222222111111111111111111111111110000000000000000000000000000000000000000000000
111111111111111111111111111111111111111111111111111111111111222222222222222222222222222222
111111111111111111111111111111111111111111111
11111111111111111111111111111111111111111111
11111111111111111111111111111111111111111111
11111111111111111111111111111111111111111111
11111111111111111111111111111111111111111111